* English (English) - EN
* Amharic (አማርኛ) - AM
* Arabic (العربية) - AR
* Azerbaijani (Azərbaycanca) - AZ
* Bengali (বাংলা) - BN
* Bulgarian (Български) - BG
* Burmese (မြန်မာ) - MY
* Chinese (中文) - ZH
* Croatian (Hrvatski) - HR
* Czech (Čeština) - CS
* Danish (Dansk) - DA
* Dutch (Nederlands) - NL
* English (English) - EN
* Estonian (Eesti) - ET
* French (Français) - FR
* Georgian (ქართული) - KA
* German (Deutsch) - DE
* Greek (Ελληνικά) - EL
* Hungarian (Magyar) - HU
* Icelandic (Íslenska) - IS
* Indonesian (Bahasa Indonesia) - ID
* Italian (Italiano) - IT
* Japanese (日本語) - JA
* Khmer (ខ្មែរ) - KM
* Korean (한국어) - KO
* Latvian (Latviešu) - LV
* Lithuanian (Lietuvių) - LT
* Malay (Bahasa Melayu) - MS
* Nepali (नेपाली) - NE
* Norwegian (Norsk) - NO
* Persian (فارسی) - FA
* Polish (Polski) - PL
* Portuguese (Português) - PT
* Romanian (Română) - RO
* Russian (Русский) - RU
* Serbian (Српски) - SR
* Slovak (Slovenčina) - SK
* Slovene (Slovenščina) - SL
* Spanish (Español) - ES
* Thai (ไทย) - TH
* Turkish (Türkçe) - TR
* Ukrainian (Українська) - UK
* Uzbek (Oʻzbekcha) - UZ
* Vietnamese (Tiếng Việt) - VI
